#
##..T...#T###
#..####.#..##
#.##.....#.##
#..#.###...##
D.#..####.
#..#.#.#
#....@#..#
#.######.#
#........#
#