##########################
#T.....................###
###T#.#####.####.##.##..##
#####.####..###...#.....T#
#.....##.##...############
#@###.##.#..##.....T######
###...##.#.#...######3..T#
###.#....#.#.##.....###.##
##....##........###.....##
##D#######################