####.########
###T......###
#########.###
#########...####
###########....#
#######.....###.#
#######@##.###.###
##########......T#
#####......#######
#########..T#.#####
#################