####D########
###T........1###
#########.#######
##T........#####
#T#.#######...T#
#.....T......##.2#
#T#.###@##.####.##
#...######......T#
###.#T.....#######
##T.#####....T#####
#################