####D########
###T......######
#########.#######
##T........#####
#T#.#######...T#
#.....T......#####
#T#.###@##.###.###
#...######......T#
###.#T.....#######
##T.#####....T#####
#################